datasetName,fileName,Ins,Ins(buggy),Ins(clean),buggy/Ins,IL,IL(buggy),IL(clean),IL/Ins,IL(buggy)/Ins(buggy),IL(clean)/Ins(clean)
ECLIPSE-2007,eclipse-2.0.csv,6727,975,5752,0.14493830830979634,80,12,68,0.011892374015162776,0.012307692307692308,0.011821974965229486
ECLIPSE-2007,eclipse-2.1.csv,7886,854,7032,0.10829317778341364,145,56,89,0.01838701496322597,0.06557377049180328,0.012656427758816837
ECLIPSE-2007,eclipse-3.0.csv,10590,1568,9022,0.14806421152030216,91,79,12,0.008593012275731822,0.05038265306122449,0.001330082021724673
Metrics-Repo-2010,ant-1.3.csv,124,20,104,0.16129032258064516,2,0,2,0.016129032258064516,0.0,0.019230769230769232
Metrics-Repo-2010,ant-1.4.csv,177,40,137,0.22598870056497175,9,5,4,0.05084745762711865,0.125,0.029197080291970802
Metrics-Repo-2010,ant-1.5.csv,290,32,258,0.1103448275862069,14,2,12,0.04827586206896552,0.0625,0.046511627906976744
Metrics-Repo-2010,ant-1.6.csv,350,92,258,0.26285714285714284,12,6,6,0.03428571428571429,0.06521739130434782,0.023255813953488372
Metrics-Repo-2010,ant-1.7.csv,740,166,574,0.22432432432432434,7,6,1,0.00945945945945946,0.03614457831325301,0.0017421602787456446
Metrics-Repo-2010,camel-1.0.csv,339,13,326,0.038348082595870206,28,1,27,0.08259587020648967,0.07692307692307693,0.08282208588957055
Metrics-Repo-2010,camel-1.2.csv,590,216,374,0.36610169491525424,82,59,23,0.13898305084745763,0.27314814814814814,0.06149732620320856
Metrics-Repo-2010,camel-1.4.csv,841,145,696,0.1724137931034483,123,23,100,0.14625445897740785,0.15862068965517243,0.14367816091954022
Metrics-Repo-2010,camel-1.6.csv,927,188,739,0.20280474649406688,109,67,42,0.11758360302049622,0.35638297872340424,0.056833558863328824
Metrics-Repo-2010,forrest-0.6.csv,6,1,5,0.16666666666666666,1,0,1,0.16666666666666666,0.0,0.2
Metrics-Repo-2010,forrest-0.7.csv,29,5,24,0.1724137931034483,1,1,0,0.034482758620689655,0.2,0.0
Metrics-Repo-2010,forrest-0.8.csv,30,2,28,0.06666666666666667,0,0,0,0.0,0.0,0.0
Metrics-Repo-2010,jedit-3.2.csv,259,87,172,0.3359073359073359,8,2,6,0.03088803088803089,0.022988505747126436,0.03488372093023256
Metrics-Repo-2010,jedit-4.0.csv,293,75,218,0.25597269624573377,18,9,9,0.06143344709897611,0.12,0.04128440366972477
Metrics-Repo-2010,jedit-4.1.csv,300,79,221,0.2633333333333333,14,7,7,0.04666666666666667,0.08860759493670886,0.03167420814479638
Metrics-Repo-2010,jedit-4.2.csv,355,47,308,0.1323943661971831,1,1,0,0.0028169014084507044,0.02127659574468085,0.0
Metrics-Repo-2010,jedit-4.3.csv,487,11,476,0.022587268993839837,1,0,1,0.002053388090349076,0.0,0.0021008403361344537
Metrics-Repo-2010,log4j-1.0.csv,115,33,82,0.28695652173913044,39,1,38,0.3391304347826087,0.030303030303030304,0.4634146341463415
Metrics-Repo-2010,log4j-1.1.csv,103,36,67,0.34951456310679613,48,6,42,0.46601941747572817,0.16666666666666666,0.6268656716417911
Metrics-Repo-2010,log4j-1.2.csv,193,184,9,0.9533678756476683,47,46,1,0.24352331606217617,0.25,0.1111111111111111
Metrics-Repo-2010,lucene-2.0.csv,186,91,95,0.489247311827957,67,1,66,0.3602150537634409,0.01098901098901099,0.6947368421052632
Metrics-Repo-2010,lucene-2.2.csv,234,143,91,0.6111111111111112,89,48,41,0.3803418803418803,0.3356643356643357,0.45054945054945056
Metrics-Repo-2010,lucene-2.4.csv,330,200,130,0.6060606060606061,55,43,12,0.16666666666666666,0.215,0.09230769230769231
Metrics-Repo-2010,pbeans-1.0.csv,26,20,6,0.7692307692307693,1,1,0,0.038461538461538464,0.05,0.0
Metrics-Repo-2010,pbeans-2.0.csv,51,10,41,0.19607843137254902,1,0,1,0.0196078431372549,0.0,0.024390243902439025
Metrics-Repo-2010,poi-1.5.csv,235,141,94,0.6,49,8,41,0.20851063829787234,0.05673758865248227,0.43617021276595747
Metrics-Repo-2010,poi-2.0.csv,309,37,272,0.11974110032362459,215,12,203,0.6957928802588996,0.32432432432432434,0.7463235294117647
Metrics-Repo-2010,poi-2.5.csv,380,247,133,0.65,240,183,57,0.631578947368421,0.7408906882591093,0.42857142857142855
Metrics-Repo-2010,poi-3.0.csv,438,281,157,0.6415525114155252,64,53,11,0.1461187214611872,0.18861209964412812,0.07006369426751592
Metrics-Repo-2010,synapse-1.0.csv,157,16,141,0.10191082802547771,10,0,10,0.06369426751592357,0.0,0.07092198581560284
Metrics-Repo-2010,synapse-1.1.csv,222,60,162,0.2702702702702703,20,9,11,0.09009009009009009,0.15,0.06790123456790123
Metrics-Repo-2010,synapse-1.2.csv,256,86,170,0.3359375,12,11,1,0.046875,0.12790697674418605,0.0058823529411764705
Metrics-Repo-2010,velocity-1.4.csv,195,147,48,0.7538461538461538,41,40,1,0.21025641025641026,0.272108843537415,0.020833333333333332
Metrics-Repo-2010,velocity-1.5.csv,214,142,72,0.6635514018691588,81,37,44,0.37850467289719625,0.2605633802816901,0.6111111111111112
Metrics-Repo-2010,velocity-1.6.csv,229,78,151,0.3406113537117904,79,8,71,0.34497816593886466,0.10256410256410256,0.47019867549668876
Metrics-Repo-2010,xalan-2.4.csv,676,110,566,0.16272189349112426,327,0,327,0.48372781065088755,0.0,0.5777385159010601
Metrics-Repo-2010,xalan-2.5.csv,762,387,375,0.5078740157480315,448,220,228,0.5879265091863517,0.5684754521963824,0.608
Metrics-Repo-2010,xalan-2.6.csv,875,411,464,0.4697142857142857,481,131,350,0.5497142857142857,0.31873479318734793,0.7543103448275862
Metrics-Repo-2010,xalan-2.7.csv,899,897,2,0.9977753058954394,314,314,0,0.3492769744160178,0.3500557413600892,0.0
Metrics-Repo-2010,xerces-0.init.csv,162,77,85,0.47530864197530864,25,22,3,0.15432098765432098,0.2857142857142857,0.03529411764705882
Metrics-Repo-2010,xerces-1.2.csv,438,70,368,0.1598173515981735,154,27,127,0.3515981735159817,0.38571428571428573,0.3451086956521739
Metrics-Repo-2010,xerces-1.3.csv,451,68,383,0.15077605321507762,212,24,188,0.4700665188470067,0.35294117647058826,0.4908616187989556
Metrics-Repo-2010,xerces-1.4.csv,331,213,118,0.6435045317220544,194,157,37,0.5861027190332326,0.7370892018779343,0.3135593220338983
JIRA-HA-2019,activemq-5.0.0.csv,1884,82,1802,0.0435244161358811,109,1,108,0.05785562632696391,0.012195121951219513,0.05993340732519423
JIRA-HA-2019,activemq-5.1.0.csv,1970,139,1831,0.07055837563451776,135,54,81,0.06852791878172589,0.38848920863309355,0.04423812124522119
JIRA-HA-2019,activemq-5.2.0.csv,2040,154,1886,0.07549019607843137,136,83,53,0.06666666666666667,0.538961038961039,0.028101802757158005
JIRA-HA-2019,activemq-5.3.0.csv,2367,142,2225,0.05999155048584706,35,31,4,0.014786649767638362,0.21830985915492956,0.0017977528089887641
JIRA-HA-2019,activemq-5.8.0.csv,3420,203,3217,0.05935672514619883,1,1,0,0.00029239766081871346,0.0049261083743842365,0.0
JIRA-HA-2019,camel-1.4.0.csv,1503,362,1141,0.24085163007318697,3,2,1,0.001996007984031936,0.0055248618784530384,0.0008764241893076249
JIRA-HA-2019,camel-2.10.0.csv,7880,311,7569,0.039467005076142134,140,84,56,0.017766497461928935,0.27009646302250806,0.007398599550799313
JIRA-HA-2019,camel-2.11.0.csv,8809,200,8609,0.0227040526734022,99,77,22,0.01123850607333409,0.385,0.00255546521082588
JIRA-HA-2019,camel-2.9.0.csv,7089,200,6889,0.028212723938496262,102,2,100,0.014388489208633094,0.01,0.014515894904920888
JIRA-HA-2019,derby-10.2.1.6.csv,1963,180,1783,0.09169638308711156,42,2,40,0.021395822720326033,0.011111111111111112,0.022434099831744252
JIRA-HA-2019,derby-10.3.1.4.csv,2206,157,2049,0.07116953762466002,56,23,33,0.025385312783318223,0.1464968152866242,0.016105417276720352
JIRA-HA-2019,derby-10.5.1.1.csv,2704,180,2524,0.06656804733727811,33,31,2,0.01220414201183432,0.17222222222222222,0.000792393026941363
JIRA-HA-2019,groovy-1.5.7.csv,756,80,676,0.10582010582010581,19,13,6,0.02513227513227513,0.1625,0.008875739644970414
JIRA-HA-2019,groovy-1.6.BETA1.csv,820,117,703,0.14268292682926828,28,13,15,0.03414634146341464,0.1111111111111111,0.021337126600284494
JIRA-HA-2019,groovy-1.6.BETA2.csv,883,103,780,0.11664779161947905,23,13,10,0.026047565118912798,0.1262135922330097,0.01282051282051282
JIRA-HA-2019,hbase-0.94.0.csv,1047,69,978,0.0659025787965616,0,0,0,0.0,0.0,0.0
JIRA-HA-2019,hbase-0.95.0.csv,1613,91,1522,0.056416615003099815,17,1,16,0.010539367637941723,0.01098901098901099,0.010512483574244415
JIRA-HA-2019,hbase-0.95.2.csv,1801,114,1687,0.06329816768461966,17,16,1,0.009439200444197668,0.14035087719298245,0.0005927682276229994
JIRA-HA-2019,hive-0.10.0.csv,1454,48,1406,0.033012379642365884,26,18,8,0.017881705639614855,0.375,0.005689900426742532
JIRA-HA-2019,hive-0.12.0.csv,2512,46,2466,0.018312101910828025,18,8,10,0.007165605095541401,0.17391304347826086,0.0040551500405515
JIRA-HA-2019,hive-0.9.0.csv,1319,49,1270,0.037149355572403335,14,0,14,0.01061410159211524,0.0,0.011023622047244094
JIRA-HA-2019,jruby-1.1.0.csv,723,161,562,0.22268326417704012,12,0,12,0.016597510373443983,0.0,0.021352313167259787
JIRA-HA-2019,jruby-1.4.0.csv,970,200,770,0.20618556701030927,78,20,58,0.08041237113402062,0.1,0.07532467532467532
JIRA-HA-2019,jruby-1.5.0.csv,1127,275,852,0.2440106477373558,78,53,25,0.06921029281277728,0.19272727272727272,0.029342723004694836
JIRA-HA-2019,jruby-1.7.0.preview1.csv,1551,162,1389,0.10444874274661509,9,8,1,0.005802707930367505,0.04938271604938271,0.0007199424046076314
JIRA-HA-2019,lucene-2.3.0.csv,803,159,644,0.1980074719800747,15,3,12,0.0186799501867995,0.018867924528301886,0.018633540372670808
JIRA-HA-2019,lucene-2.9.0.csv,1360,276,1084,0.20294117647058824,22,11,11,0.016176470588235296,0.03985507246376811,0.01014760147601476
JIRA-HA-2019,lucene-3.0.0.csv,1330,189,1141,0.14210526315789473,29,6,23,0.02180451127819549,0.031746031746031744,0.020157756354075372
JIRA-HA-2019,lucene-3.1.0.csv,1802,310,1492,0.17203107658157601,26,20,6,0.014428412874583796,0.06451612903225806,0.004021447721179625
JIRA-HA-2019,wicket-1.3.0.beta1.csv,1669,288,1381,0.1725584182144997,0,0,0,0.0,0.0,0.0
JIRA-HA-2019,wicket-1.3.0.beta2.csv,1760,305,1455,0.17329545454545456,0,0,0,0.0,0.0,0.0
JIRA-HA-2019,wicket-1.5.3.0.csv,2570,93,2477,0.03618677042801557,0,0,0,0.0,0.0,0.0
JIRA-RA-2019,activemq-5.0.0.csv,1884,293,1591,0.15552016985138004,233,99,134,0.12367303609341826,0.3378839590443686,0.0842237586423633
JIRA-RA-2019,activemq-5.1.0.csv,1970,154,1816,0.07817258883248732,282,50,232,0.1431472081218274,0.3246753246753247,0.1277533039647577
JIRA-RA-2019,activemq-5.2.0.csv,2040,219,1821,0.10735294117647058,272,111,161,0.13333333333333333,0.5068493150684932,0.08841295991213619
JIRA-RA-2019,activemq-5.3.0.csv,2367,258,2109,0.10899873257287707,170,73,97,0.07182087029995775,0.28294573643410853,0.04599336178283547
JIRA-RA-2019,activemq-5.8.0.csv,3420,206,3214,0.06023391812865497,13,2,11,0.003801169590643275,0.009708737864077669,0.003422526446795271
JIRA-RA-2019,camel-1.4.0.csv,1503,284,1219,0.18895542248835662,4,4,0,0.0026613439787092482,0.014084507042253521,0.0
JIRA-RA-2019,camel-2.10.0.csv,7880,230,7650,0.02918781725888325,131,60,71,0.0166243654822335,0.2608695652173913,0.009281045751633988
JIRA-RA-2019,camel-2.11.0.csv,8809,192,8617,0.021795890566466115,99,56,43,0.01123850607333409,0.2916666666666667,0.004990135778113032
JIRA-RA-2019,camel-2.9.0.csv,7089,199,6890,0.02807166031880378,78,13,65,0.011002962336013541,0.06532663316582915,0.009433962264150943
JIRA-RA-2019,derby-10.2.1.6.csv,1963,661,1302,0.336729495669893,163,125,38,0.08303616912888435,0.18910741301059,0.029185867895545316
JIRA-RA-2019,derby-10.3.1.4.csv,2206,669,1537,0.30326382592928375,281,165,116,0.1273798730734361,0.24663677130044842,0.07547169811320754
JIRA-RA-2019,derby-10.5.1.1.csv,2704,383,2321,0.14164201183431951,217,19,198,0.08025147928994082,0.04960835509138381,0.08530805687203792
JIRA-RA-2019,groovy-1.5.7.csv,756,26,730,0.03439153439153439,20,5,15,0.026455026455026454,0.19230769230769232,0.02054794520547945
JIRA-RA-2019,groovy-1.6.BETA1.csv,820,70,750,0.08536585365853659,19,9,10,0.023170731707317073,0.12857142857142856,0.013333333333333334
JIRA-RA-2019,groovy-1.6.BETA2.csv,883,76,807,0.08607021517553794,19,9,10,0.021517553793884484,0.11842105263157894,0.012391573729863693
JIRA-RA-2019,hbase-0.94.0.csv,1047,216,831,0.20630372492836677,0,0,0,0.0,0.0,0.0
JIRA-RA-2019,hbase-0.95.0.csv,1613,378,1235,0.23434593924364538,101,14,87,0.06261624302541847,0.037037037037037035,0.07044534412955465
JIRA-RA-2019,hbase-0.95.2.csv,1801,483,1318,0.2681843420322043,101,87,14,0.0560799555802332,0.18012422360248448,0.010622154779969651
JIRA-RA-2019,hive-0.10.0.csv,1454,175,1279,0.1203576341127923,68,36,32,0.04676753782668501,0.2057142857142857,0.02501954652071931
JIRA-RA-2019,hive-0.12.0.csv,2512,208,2304,0.08280254777070063,50,3,47,0.019904458598726114,0.014423076923076924,0.020399305555555556
JIRA-RA-2019,hive-0.9.0.csv,1319,249,1070,0.18877937831690675,43,29,14,0.032600454890068235,0.11646586345381527,0.013084112149532711
JIRA-RA-2019,jruby-1.1.0.csv,723,87,636,0.12033195020746888,4,0,4,0.005532503457814661,0.0,0.006289308176100629
JIRA-RA-2019,jruby-1.4.0.csv,970,180,790,0.18556701030927836,17,13,4,0.01752577319587629,0.07222222222222222,0.005063291139240506
JIRA-RA-2019,jruby-1.5.0.csv,1127,81,1046,0.07187222715173026,17,6,11,0.015084294587400177,0.07407407407407407,0.010516252390057362
JIRA-RA-2019,jruby-1.7.0.preview1.csv,1551,82,1469,0.052869116698903935,7,1,6,0.004513217279174726,0.012195121951219513,0.0040844111640571815
JIRA-RA-2019,lucene-2.3.0.csv,803,195,608,0.24283935242839352,10,9,1,0.012453300124533,0.046153846153846156,0.001644736842105263
JIRA-RA-2019,lucene-2.9.0.csv,1360,269,1091,0.19779411764705881,32,23,9,0.023529411764705882,0.08550185873605948,0.008249312557286892
JIRA-RA-2019,lucene-3.0.0.csv,1330,152,1178,0.11428571428571428,31,4,27,0.02330827067669173,0.02631578947368421,0.022920203735144314
JIRA-RA-2019,lucene-3.1.0.csv,1802,102,1700,0.05660377358490566,16,1,15,0.008879023307436182,0.00980392156862745,0.008823529411764706
JIRA-RA-2019,wicket-1.3.0.beta1.csv,1669,101,1568,0.06051527860994608,49,4,45,0.029358897543439184,0.039603960396039604,0.028698979591836735
JIRA-RA-2019,wicket-1.3.0.beta2.csv,1760,130,1630,0.07386363636363637,49,45,4,0.02784090909090909,0.34615384615384615,0.00245398773006135
JIRA-RA-2019,wicket-1.5.3.0.csv,2570,104,2466,0.04046692607003891,0,0,0,0.0,0.0,0.0
MA-SZZ-2020,zeppelin-0.5.0.csv,129,37,92,0.2868217054263566,6,4,2,0.046511627906976744,0.10810810810810811,0.021739130434782608
MA-SZZ-2020,zeppelin-0.5.5.csv,168,55,113,0.3273809523809524,9,6,3,0.05357142857142857,0.10909090909090909,0.02654867256637168
MA-SZZ-2020,zeppelin-0.5.6.csv,188,58,130,0.30851063829787234,9,3,6,0.047872340425531915,0.05172413793103448,0.046153846153846156
MA-SZZ-2020,zeppelin-0.6.0.csv,289,110,179,0.3806228373702422,21,13,8,0.0726643598615917,0.11818181818181818,0.0446927374301676
MA-SZZ-2020,zeppelin-0.6.1.csv,293,106,187,0.36177474402730375,21,10,11,0.07167235494880546,0.09433962264150944,0.058823529411764705
MA-SZZ-2020,zeppelin-0.6.2.csv,294,99,195,0.336734693877551,22,5,17,0.07482993197278912,0.050505050505050504,0.08717948717948718
MA-SZZ-2020,zeppelin-0.7.0.csv,409,109,300,0.2665036674816626,19,15,4,0.04645476772616137,0.13761467889908258,0.013333333333333334
MA-SZZ-2020,zeppelin-0.7.1.csv,410,99,311,0.24146341463414633,22,14,8,0.05365853658536585,0.1414141414141414,0.02572347266881029
MA-SZZ-2020,zeppelin-0.7.2.csv,411,97,314,0.2360097323600973,24,18,6,0.058394160583941604,0.18556701030927836,0.01910828025477707
MA-SZZ-2020,zeppelin-0.7.3.csv,413,86,327,0.20823244552058112,23,9,14,0.05569007263922518,0.10465116279069768,0.04281345565749235
MA-SZZ-2020,shiro-1.1.0.csv,381,24,357,0.06299212598425197,0,0,0,0.0,0.0,0.0
MA-SZZ-2020,shiro-1.2.0.csv,463,31,432,0.06695464362850972,1,1,0,0.0021598272138228943,0.03225806451612903,0.0
MA-SZZ-2020,shiro-1.2.1.csv,464,29,435,0.0625,1,1,0,0.0021551724137931034,0.034482758620689655,0.0
MA-SZZ-2020,shiro-1.2.2.csv,465,18,447,0.03870967741935484,1,0,1,0.002150537634408602,0.0,0.0022371364653243847
MA-SZZ-2020,shiro-1.2.3.csv,466,18,448,0.03862660944206009,1,0,1,0.002145922746781116,0.0,0.002232142857142857
MA-SZZ-2020,shiro-1.2.4.csv,466,18,448,0.03862660944206009,1,0,1,0.002145922746781116,0.0,0.002232142857142857
MA-SZZ-2020,shiro-1.2.5.csv,466,18,448,0.03862660944206009,1,0,1,0.002145922746781116,0.0,0.002232142857142857
MA-SZZ-2020,shiro-1.2.6.csv,466,18,448,0.03862660944206009,1,0,1,0.002145922746781116,0.0,0.002232142857142857
MA-SZZ-2020,shiro-1.3.0.csv,493,16,477,0.032454361054766734,1,0,1,0.002028397565922921,0.0,0.0020964360587002098
MA-SZZ-2020,shiro-1.3.1.csv,493,16,477,0.032454361054766734,1,0,1,0.002028397565922921,0.0,0.0020964360587002098
MA-SZZ-2020,maven-2.2.0.csv,318,16,302,0.050314465408805034,2,2,0,0.006289308176100629,0.125,0.0
MA-SZZ-2020,maven-2.2.1.csv,323,14,309,0.043343653250773995,2,0,2,0.006191950464396285,0.0,0.006472491909385114
MA-SZZ-2020,maven-3.0.0.csv,664,88,576,0.13253012048192772,5,4,1,0.007530120481927711,0.045454545454545456,0.001736111111111111
MA-SZZ-2020,maven-3.0.1.csv,667,82,585,0.12293853073463268,6,5,1,0.008995502248875561,0.06097560975609756,0.0017094017094017094
MA-SZZ-2020,maven-3.0.2.csv,678,77,601,0.11356932153392331,7,6,1,0.01032448377581121,0.07792207792207792,0.0016638935108153079
MA-SZZ-2020,maven-3.0.3.csv,679,67,612,0.09867452135493372,7,6,1,0.010309278350515464,0.08955223880597014,0.0016339869281045752
MA-SZZ-2020,maven-3.0.4.csv,681,65,616,0.09544787077826726,9,6,3,0.013215859030837005,0.09230769230769231,0.00487012987012987
MA-SZZ-2020,maven-3.0.5.csv,681,62,619,0.09104258443465492,9,3,6,0.013215859030837005,0.04838709677419355,0.009693053311793215
MA-SZZ-2020,maven-3.1.0.csv,702,65,637,0.09259259259259259,0,0,0,0.0,0.0,0.0
MA-SZZ-2020,maven-3.1.1.csv,703,65,638,0.09246088193456614,0,0,0,0.0,0.0,0.0
MA-SZZ-2020,flume-1.2.0.csv,272,87,185,0.31985294117647056,8,8,0,0.029411764705882353,0.09195402298850575,0.0
MA-SZZ-2020,flume-1.3.0.csv,370,117,253,0.3162162162162162,17,16,1,0.04594594594594595,0.13675213675213677,0.003952569169960474
MA-SZZ-2020,flume-1.3.1.csv,371,107,264,0.2884097035040431,18,11,7,0.04851752021563342,0.102803738317757,0.026515151515151516
MA-SZZ-2020,flume-1.4.0.csv,453,127,326,0.2803532008830022,27,27,0,0.059602649006622516,0.2125984251968504,0.0
MA-SZZ-2020,flume-1.5.0.csv,490,110,380,0.22448979591836735,35,33,2,0.07142857142857142,0.3,0.005263157894736842
MA-SZZ-2020,flume-1.5.1.csv,490,76,414,0.15510204081632653,35,1,34,0.07142857142857142,0.013157894736842105,0.0821256038647343
MA-SZZ-2020,flume-1.5.2.csv,490,76,414,0.15510204081632653,35,1,34,0.07142857142857142,0.013157894736842105,0.0821256038647343
MA-SZZ-2020,flume-1.6.0.csv,546,72,474,0.13186813186813187,0,0,0,0.0,0.0,0.0
MA-SZZ-2020,flume-1.7.0.csv,563,55,508,0.09769094138543517,0,0,0,0.0,0.0,0.0
MA-SZZ-2020,flume-1.8.0.csv,574,21,553,0.036585365853658534,0,0,0,0.0,0.0,0.0
MA-SZZ-2020,mahout-0.10.0.csv,1152,198,954,0.171875,1,1,0,0.0008680555555555555,0.005050505050505051,0.0
MA-SZZ-2020,mahout-0.11.0.csv,1157,200,957,0.17286084701815038,1,1,0,0.000864304235090752,0.005,0.0
MA-SZZ-2020,mahout-0.12.0.csv,1122,200,922,0.17825311942959002,1,1,0,0.00089126559714795,0.005,0.0
MA-SZZ-2020,mahout-0.13.0.csv,1126,186,940,0.16518650088809947,0,0,0,0.0,0.0,0.0
MA-SZZ-2020,mahout-0.4.csv,1027,300,727,0.2921129503407984,0,0,0,0.0,0.0,0.0
MA-SZZ-2020,mahout-0.5.csv,1097,283,814,0.25797629899726526,0,0,0,0.0,0.0,0.0
MA-SZZ-2020,mahout-0.6.csv,1267,333,934,0.2628255722178374,0,0,0,0.0,0.0,0.0
MA-SZZ-2020,mahout-0.7.csv,1130,304,826,0.26902654867256637,0,0,0,0.0,0.0,0.0
MA-SZZ-2020,mahout-0.8.csv,1265,314,951,0.2482213438735178,0,0,0,0.0,0.0,0.0
MA-SZZ-2020,mahout-0.9.csv,1168,268,900,0.22945205479452055,1,0,1,0.0008561643835616438,0.0,0.0011111111111111111
IND-JLMIV+R-2020,ant-ivy-1.4.1.csv,240,11,229,0.04583333333333333,0,0,0,0.0,0.0,0.0
IND-JLMIV+R-2020,ant-ivy-2.0.0.csv,352,50,302,0.14204545454545456,7,2,5,0.019886363636363636,0.04,0.016556291390728478
IND-JLMIV+R-2020,ant-ivy-2.1.0.csv,357,49,308,0.13725490196078433,7,4,3,0.0196078431372549,0.08163265306122448,0.00974025974025974
IND-JLMIV+R-2020,ant-ivy-2.2.0.csv,363,37,326,0.10192837465564739,2,1,1,0.005509641873278237,0.02702702702702703,0.003067484662576687
IND-JLMIV+R-2020,ant-ivy-2.3.0.csv,451,13,438,0.028824833702882482,3,1,2,0.0066518847006651885,0.07692307692307693,0.0045662100456621
IND-JLMIV+R-2020,ant-ivy-2.4.0.csv,474,17,457,0.035864978902953586,2,2,0,0.004219409282700422,0.11764705882352941,0.0
IND-JLMIV+R-2020,archiva-1.0.csv,429,6,423,0.013986013986013986,3,0,3,0.006993006993006993,0.0,0.0070921985815602835
IND-JLMIV+R-2020,archiva-1.1.csv,449,28,421,0.062360801781737196,5,3,2,0.011135857461024499,0.10714285714285714,0.004750593824228029
IND-JLMIV+R-2020,archiva-1.2.csv,433,19,414,0.04387990762124711,5,1,4,0.011547344110854504,0.05263157894736842,0.00966183574879227
IND-JLMIV+R-2020,archiva-1.3.csv,434,15,419,0.03456221198156682,5,5,0,0.01152073732718894,0.3333333333333333,0.0
IND-JLMIV+R-2020,archiva-2.0.csv,420,7,413,0.016666666666666666,0,0,0,0.0,0.0,0.0
IND-JLMIV+R-2020,archiva-2.1.csv,419,5,414,0.011933174224343675,0,0,0,0.0,0.0,0.0
IND-JLMIV+R-2020,archiva-2.2.csv,418,3,415,0.007177033492822967,0,0,0,0.0,0.0,0.0
IND-JLMIV+R-2020,calcite-1.0.0.csv,1075,178,897,0.1655813953488372,17,0,17,0.01581395348837209,0.0,0.0189520624303233
IND-JLMIV+R-2020,calcite-1.1.0.csv,1103,113,990,0.10244786944696282,21,1,20,0.019038984587488667,0.008849557522123894,0.020202020202020204
IND-JLMIV+R-2020,calcite-1.10.0.csv,1310,84,1226,0.06412213740458016,26,10,16,0.01984732824427481,0.11904761904761904,0.013050570962479609
IND-JLMIV+R-2020,calcite-1.11.0.csv,1331,80,1251,0.06010518407212622,20,15,5,0.015026296018031555,0.1875,0.003996802557953637
IND-JLMIV+R-2020,calcite-1.12.0.csv,1415,81,1334,0.05724381625441696,9,8,1,0.0063604240282685515,0.09876543209876543,0.0007496251874062968
IND-JLMIV+R-2020,calcite-1.13.0.csv,1275,53,1222,0.04156862745098039,3,3,0,0.002352941176470588,0.05660377358490566,0.0
IND-JLMIV+R-2020,calcite-1.14.0.csv,1308,53,1255,0.040519877675840976,2,2,0,0.0015290519877675841,0.03773584905660377,0.0
IND-JLMIV+R-2020,calcite-1.15.0.csv,1352,45,1307,0.03328402366863906,1,1,0,0.0007396449704142012,0.022222222222222223,0.0
IND-JLMIV+R-2020,calcite-1.2.0.csv,1108,126,982,0.11371841155234658,22,5,17,0.019855595667870037,0.03968253968253968,0.017311608961303463
IND-JLMIV+R-2020,calcite-1.3.0.csv,1115,112,1003,0.10044843049327354,22,8,14,0.019730941704035873,0.07142857142857142,0.013958125623130608
IND-JLMIV+R-2020,calcite-1.4.0.csv,1127,123,1004,0.10913930789707187,21,15,6,0.018633540372670808,0.12195121951219512,0.00597609561752988
IND-JLMIV+R-2020,calcite-1.5.0.csv,1176,103,1073,0.08758503401360544,13,4,9,0.011054421768707483,0.038834951456310676,0.008387698042870456
IND-JLMIV+R-2020,calcite-1.6.0.csv,1193,107,1086,0.08968985750209556,16,2,14,0.013411567476948869,0.018691588785046728,0.01289134438305709
IND-JLMIV+R-2020,calcite-1.7.0.csv,1252,128,1124,0.10223642172523961,18,8,10,0.01437699680511182,0.0625,0.008896797153024912
IND-JLMIV+R-2020,calcite-1.8.0.csv,1301,101,1200,0.07763259031514219,24,9,15,0.018447348193697154,0.0891089108910891,0.0125
IND-JLMIV+R-2020,calcite-1.9.0.csv,1310,90,1220,0.06870229007633588,23,6,17,0.017557251908396947,0.06666666666666667,0.013934426229508197
IND-JLMIV+R-2020,cayenne-3.0.0.csv,1708,44,1664,0.02576112412177986,3,0,3,0.001756440281030445,0.0,0.0018028846153846155
IND-JLMIV+R-2020,cayenne-3.1.0.csv,1578,19,1559,0.012040557667934094,3,3,0,0.0019011406844106464,0.15789473684210525,0.0
IND-JLMIV+R-2020,commons-bcel-5.0.csv,325,0,325,0.0,0,0,0,0.0,,0.0
IND-JLMIV+R-2020,commons-bcel-5.1.csv,334,0,334,0.0,0,0,0,0.0,,0.0
IND-JLMIV+R-2020,commons-bcel-5.2.csv,335,1,334,0.0029850746268656717,0,0,0,0.0,0.0,0.0
IND-JLMIV+R-2020,commons-bcel-6.0.csv,376,13,363,0.034574468085106384,1,0,1,0.0026595744680851063,0.0,0.0027548209366391185
IND-JLMIV+R-2020,commons-bcel-6.1.csv,378,10,368,0.026455026455026454,1,1,0,0.0026455026455026454,0.1,0.0
IND-JLMIV+R-2020,commons-bcel-6.2.csv,378,9,369,0.023809523809523808,1,1,0,0.0026455026455026454,0.1111111111111111,0.0
IND-JLMIV+R-2020,commons-beanutils-1.0.csv,3,0,3,0.0,0,0,0,0.0,,0.0
IND-JLMIV+R-2020,commons-beanutils-1.1.csv,4,0,4,0.0,0,0,0,0.0,,0.0
IND-JLMIV+R-2020,commons-beanutils-1.2.csv,5,0,5,0.0,0,0,0,0.0,,0.0
IND-JLMIV+R-2020,commons-beanutils-1.3.csv,29,0,29,0.0,0,0,0,0.0,,0.0
IND-JLMIV+R-2020,commons-beanutils-1.4.csv,43,0,43,0.0,0,0,0,0.0,,0.0
IND-JLMIV+R-2020,commons-beanutils-1.5.csv,62,0,62,0.0,0,0,0,0.0,,0.0
IND-JLMIV+R-2020,commons-beanutils-1.6.csv,64,0,64,0.0,0,0,0,0.0,,0.0
IND-JLMIV+R-2020,commons-beanutils-1.7.0.csv,87,7,80,0.08045977011494253,0,0,0,0.0,0.0,0.0
IND-JLMIV+R-2020,commons-beanutils-1.8.0.csv,101,8,93,0.07920792079207921,0,0,0,0.0,0.0,0.0
IND-JLMIV+R-2020,commons-beanutils-1.9.0.csv,104,1,103,0.009615384615384616,0,0,0,0.0,0.0,0.0
IND-JLMIV+R-2020,commons-codec-1.1.csv,14,0,14,0.0,0,0,0,0.0,,0.0
IND-JLMIV+R-2020,commons-codec-1.10.csv,60,3,57,0.05,0,0,0,0.0,0.0,0.0
IND-JLMIV+R-2020,commons-codec-1.11.csv,64,0,64,0.0,0,0,0,0.0,,0.0
IND-JLMIV+R-2020,commons-codec-1.2.csv,17,2,15,0.11764705882352941,0,0,0,0.0,0.0,0.0
IND-JLMIV+R-2020,commons-codec-1.3.csv,24,3,21,0.125,0,0,0,0.0,0.0,0.0
IND-JLMIV+R-2020,commons-codec-1.4.csv,29,0,29,0.0,0,0,0,0.0,,0.0
IND-JLMIV+R-2020,commons-codec-1.5.csv,39,1,38,0.02564102564102564,0,0,0,0.0,0.0,0.0
IND-JLMIV+R-2020,commons-codec-1.6.csv,47,4,43,0.0851063829787234,0,0,0,0.0,0.0,0.0
IND-JLMIV+R-2020,commons-codec-1.7.csv,55,3,52,0.05454545454545454,0,0,0,0.0,0.0,0.0
IND-JLMIV+R-2020,commons-codec-1.8.csv,56,6,50,0.10714285714285714,0,0,0,0.0,0.0,0.0
IND-JLMIV+R-2020,commons-codec-1.9.csv,56,6,50,0.10714285714285714,0,0,0,0.0,0.0,0.0
IND-JLMIV+R-2020,commons-collections-1.0.csv,26,1,25,0.038461538461538464,0,0,0,0.0,0.0,0.0
IND-JLMIV+R-2020,commons-collections-2.0.csv,44,1,43,0.022727272727272728,0,0,0,0.0,0.0,0.0
IND-JLMIV+R-2020,commons-collections-2.1.csv,72,1,71,0.013888888888888888,0,0,0,0.0,0.0,0.0
IND-JLMIV+R-2020,commons-collections-3.0.csv,248,8,240,0.03225806451612903,0,0,0,0.0,0.0,0.0
IND-JLMIV+R-2020,commons-collections-3.1.csv,267,8,259,0.0299625468164794,0,0,0,0.0,0.0,0.0
IND-JLMIV+R-2020,commons-collections-3.2.csv,273,11,262,0.040293040293040296,0,0,0,0.0,0.0,0.0
IND-JLMIV+R-2020,commons-collections-3.3.csv,273,10,263,0.03663003663003663,0,0,0,0.0,0.0,0.0
IND-JLMIV+R-2020,commons-collections-4.0.csv,270,14,256,0.05185185185185185,2,2,0,0.007407407407407408,0.14285714285714285,0.0
IND-JLMIV+R-2020,commons-collections-4.1.csv,301,1,300,0.0033222591362126247,2,0,2,0.006644518272425249,0.0,0.006666666666666667
IND-JLMIV+R-2020,commons-compress-1.0.csv,61,17,44,0.2786885245901639,0,0,0,0.0,0.0,0.0
IND-JLMIV+R-2020,commons-compress-1.1.csv,66,14,52,0.21212121212121213,1,0,1,0.015151515151515152,0.0,0.019230769230769232
IND-JLMIV+R-2020,commons-compress-1.10.csv,158,18,140,0.11392405063291139,1,1,0,0.006329113924050633,0.05555555555555555,0.0
IND-JLMIV+R-2020,commons-compress-1.11.csv,165,13,152,0.07878787878787878,0,0,0,0.0,0.0,0.0
IND-JLMIV+R-2020,commons-compress-1.12.csv,166,10,156,0.060240963855421686,4,0,4,0.024096385542168676,0.0,0.02564102564102564
IND-JLMIV+R-2020,commons-compress-1.13.csv,177,17,160,0.096045197740113,4,4,0,0.022598870056497175,0.23529411764705882,0.0
IND-JLMIV+R-2020,commons-compress-1.14.csv,195,8,187,0.041025641025641026,1,0,1,0.005128205128205128,0.0,0.0053475935828877
IND-JLMIV+R-2020,commons-compress-1.15.csv,195,6,189,0.03076923076923077,1,0,1,0.005128205128205128,0.0,0.005291005291005291
IND-JLMIV+R-2020,commons-compress-1.16.csv,201,6,195,0.029850746268656716,1,1,0,0.004975124378109453,0.16666666666666666,0.0
IND-JLMIV+R-2020,commons-compress-1.2.csv,69,10,59,0.14492753623188406,1,0,1,0.014492753623188406,0.0,0.01694915254237288
IND-JLMIV+R-2020,commons-compress-1.3.csv,93,16,77,0.17204301075268819,2,0,2,0.021505376344086023,0.0,0.025974025974025976
IND-JLMIV+R-2020,commons-compress-1.4.csv,99,16,83,0.16161616161616163,3,1,2,0.030303030303030304,0.0625,0.024096385542168676
IND-JLMIV+R-2020,commons-compress-1.5.csv,103,21,82,0.20388349514563106,2,0,2,0.019417475728155338,0.0,0.024390243902439025
IND-JLMIV+R-2020,commons-compress-1.6.csv,124,23,101,0.18548387096774194,3,0,3,0.024193548387096774,0.0,0.0297029702970297
IND-JLMIV+R-2020,commons-compress-1.7.csv,136,27,109,0.19852941176470587,4,2,2,0.029411764705882353,0.07407407407407407,0.01834862385321101
IND-JLMIV+R-2020,commons-compress-1.8.csv,141,31,110,0.2198581560283688,4,2,2,0.028368794326241134,0.06451612903225806,0.01818181818181818
IND-JLMIV+R-2020,commons-compress-1.9.csv,145,23,122,0.15862068965517243,2,2,0,0.013793103448275862,0.08695652173913043,0.0
IND-JLMIV+R-2020,commons-configuration-1.0.csv,29,6,23,0.20689655172413793,0,0,0,0.0,0.0,0.0
IND-JLMIV+R-2020,commons-configuration-1.1.csv,42,9,33,0.21428571428571427,0,0,0,0.0,0.0,0.0
IND-JLMIV+R-2020,commons-configuration-1.10.csv,108,7,101,0.06481481481481481,3,0,3,0.027777777777777776,0.0,0.0297029702970297
IND-JLMIV+R-2020,commons-configuration-1.2.csv,53,15,38,0.2830188679245283,1,0,1,0.018867924528301886,0.0,0.02631578947368421
IND-JLMIV+R-2020,commons-configuration-1.3.csv,84,24,60,0.2857142857142857,1,1,0,0.011904761904761904,0.041666666666666664,0.0
IND-JLMIV+R-2020,commons-configuration-1.4.csv,91,16,75,0.17582417582417584,0,0,0,0.0,0.0,0.0
IND-JLMIV+R-2020,commons-configuration-1.5.csv,92,16,76,0.17391304347826086,0,0,0,0.0,0.0,0.0
IND-JLMIV+R-2020,commons-configuration-1.6.csv,96,10,86,0.10416666666666667,0,0,0,0.0,0.0,0.0
IND-JLMIV+R-2020,commons-configuration-1.7.csv,114,11,103,0.09649122807017543,0,0,0,0.0,0.0,0.0
IND-JLMIV+R-2020,commons-configuration-1.8.csv,108,11,97,0.10185185185185185,0,0,0,0.0,0.0,0.0
IND-JLMIV+R-2020,commons-configuration-1.9.csv,108,11,97,0.10185185185185185,3,3,0,0.027777777777777776,0.2727272727272727,0.0
IND-JLMIV+R-2020,commons-configuration-2.0.csv,231,9,222,0.03896103896103896,0,0,0,0.0,0.0,0.0
IND-JLMIV+R-2020,commons-configuration-2.1.csv,233,7,226,0.030042918454935622,0,0,0,0.0,0.0,0.0
IND-JLMIV+R-2020,commons-configuration-2.2.csv,240,7,233,0.029166666666666667,0,0,0,0.0,0.0,0.0
IND-JLMIV+R-2020,commons-dbcp-1.0.csv,32,1,31,0.03125,0,0,0,0.0,0.0,0.0
IND-JLMIV+R-2020,commons-dbcp-1.1.csv,39,8,31,0.20512820512820512,2,0,2,0.05128205128205128,0.0,0.06451612903225806
IND-JLMIV+R-2020,commons-dbcp-1.2.csv,39,14,25,0.358974358974359,2,2,0,0.05128205128205128,0.14285714285714285,0.0
IND-JLMIV+R-2020,commons-dbcp-1.3.csv,53,11,42,0.20754716981132076,0,0,0,0.0,0.0,0.0
IND-JLMIV+R-2020,commons-dbcp-1.4.csv,53,11,42,0.20754716981132076,0,0,0,0.0,0.0,0.0
IND-JLMIV+R-2020,commons-dbcp-2.0.csv,53,8,45,0.1509433962264151,0,0,0,0.0,0.0,0.0
IND-JLMIV+R-2020,commons-dbcp-2.1.csv,54,7,47,0.12962962962962962,0,0,0,0.0,0.0,0.0
IND-JLMIV+R-2020,commons-dbcp-2.2.csv,54,2,52,0.037037037037037035,1,0,1,0.018518518518518517,0.0,0.019230769230769232
IND-JLMIV+R-2020,commons-dbcp-2.3.csv,55,2,53,0.03636363636363636,1,1,0,0.01818181818181818,0.5,0.0
IND-JLMIV+R-2020,commons-dbcp-2.4.csv,56,1,55,0.017857142857142856,0,0,0,0.0,0.0,0.0
IND-JLMIV+R-2020,commons-dbcp-2.5.csv,56,1,55,0.017857142857142856,0,0,0,0.0,0.0,0.0
IND-JLMIV+R-2020,commons-digester-1.0.csv,14,0,14,0.0,0,0,0,0.0,,0.0
IND-JLMIV+R-2020,commons-digester-1.1.csv,22,0,22,0.0,0,0,0,0.0,,0.0
IND-JLMIV+R-2020,commons-digester-1.2.csv,31,0,31,0.0,0,0,0,0.0,,0.0
IND-JLMIV+R-2020,commons-digester-1.3.csv,31,0,31,0.0,0,0,0,0.0,,0.0
IND-JLMIV+R-2020,commons-digester-1.4.csv,33,1,32,0.030303030303030304,0,0,0,0.0,0.0,0.0
IND-JLMIV+R-2020,commons-digester-1.5.csv,37,2,35,0.05405405405405406,0,0,0,0.0,0.0,0.0
IND-JLMIV+R-2020,commons-digester-1.6.csv,68,2,66,0.029411764705882353,0,0,0,0.0,0.0,0.0
IND-JLMIV+R-2020,commons-digester-1.7.csv,69,2,67,0.028985507246376812,0,0,0,0.0,0.0,0.0
IND-JLMIV+R-2020,commons-digester-1.8.csv,70,2,68,0.02857142857142857,0,0,0,0.0,0.0,0.0
IND-JLMIV+R-2020,commons-digester-2.0.csv,70,0,70,0.0,0,0,0,0.0,,0.0
IND-JLMIV+R-2020,commons-digester-2.1.csv,114,0,114,0.0,0,0,0,0.0,,0.0
IND-JLMIV+R-2020,commons-digester-3.0.csv,154,7,147,0.045454545454545456,1,0,1,0.006493506493506494,0.0,0.006802721088435374
IND-JLMIV+R-2020,commons-digester-3.1.csv,154,7,147,0.045454545454545456,2,0,2,0.012987012987012988,0.0,0.013605442176870748
IND-JLMIV+R-2020,commons-digester-3.2.csv,157,10,147,0.06369426751592357,2,2,0,0.012738853503184714,0.2,0.0
IND-JLMIV+R-2020,commons-io-1.0.csv,34,5,29,0.14705882352941177,0,0,0,0.0,0.0,0.0
IND-JLMIV+R-2020,commons-io-1.1.csv,39,7,32,0.1794871794871795,0,0,0,0.0,0.0,0.0
IND-JLMIV+R-2020,commons-io-1.2.csv,42,8,34,0.19047619047619047,0,0,0,0.0,0.0,0.0
IND-JLMIV+R-2020,commons-io-1.3.csv,54,12,42,0.2222222222222222,0,0,0,0.0,0.0,0.0
IND-JLMIV+R-2020,commons-io-1.4.csv,72,10,62,0.1388888888888889,0,0,0,0.0,0.0,0.0
IND-JLMIV+R-2020,commons-io-2.0.csv,100,8,92,0.08,0,0,0,0.0,0.0,0.0
IND-JLMIV+R-2020,commons-io-2.1.csv,100,6,94,0.06,0,0,0,0.0,0.0,0.0
IND-JLMIV+R-2020,commons-io-2.2.csv,102,8,94,0.0784313725490196,0,0,0,0.0,0.0,0.0
IND-JLMIV+R-2020,commons-io-2.3.csv,103,8,95,0.07766990291262135,0,0,0,0.0,0.0,0.0
IND-JLMIV+R-2020,commons-io-2.4.csv,103,8,95,0.07766990291262135,0,0,0,0.0,0.0,0.0
IND-JLMIV+R-2020,commons-io-2.5.csv,115,4,111,0.034782608695652174,0,0,0,0.0,0.0,0.0
IND-JLMIV+R-2020,commons-jcs-1.0.csv,215,1,214,0.004651162790697674,1,0,1,0.004651162790697674,0.0,0.004672897196261682
IND-JLMIV+R-2020,commons-jcs-1.1.csv,213,2,211,0.009389671361502348,1,0,1,0.004694835680751174,0.0,0.004739336492890996
IND-JLMIV+R-2020,commons-jcs-1.3.csv,275,12,263,0.04363636363636364,1,1,0,0.0036363636363636364,0.08333333333333333,0.0
IND-JLMIV+R-2020,commons-jcs-2.0.csv,368,12,356,0.03260869565217391,0,0,0,0.0,0.0,0.0
IND-JLMIV+R-2020,commons-jcs-2.1.csv,368,11,357,0.029891304347826088,0,0,0,0.0,0.0,0.0
IND-JLMIV+R-2020,commons-jcs-2.2.csv,368,4,364,0.010869565217391304,0,0,0,0.0,0.0,0.0
IND-JLMIV+R-2020,commons-jexl-1.0.csv,82,0,82,0.0,0,0,0,0.0,,0.0
IND-JLMIV+R-2020,commons-jexl-1.1.csv,85,0,85,0.0,0,0,0,0.0,,0.0
IND-JLMIV+R-2020,commons-jexl-2.0.csv,52,5,47,0.09615384615384616,0,0,0,0.0,0.0,0.0
IND-JLMIV+R-2020,commons-jexl-2.1.csv,69,6,63,0.08695652173913043,0,0,0,0.0,0.0,0.0
IND-JLMIV+R-2020,commons-jexl-3.0.csv,82,0,82,0.0,0,0,0,0.0,,0.0
IND-JLMIV+R-2020,commons-jexl-3.1.csv,85,0,85,0.0,0,0,0,0.0,,0.0
IND-JLMIV+R-2020,commons-lang-1.0.csv,26,0,26,0.0,0,0,0,0.0,,0.0
IND-JLMIV+R-2020,commons-lang-2.0.csv,57,7,50,0.12280701754385964,0,0,0,0.0,0.0,0.0
IND-JLMIV+R-2020,commons-lang-2.1.csv,74,13,61,0.17567567567567569,0,0,0,0.0,0.0,0.0
IND-JLMIV+R-2020,commons-lang-2.2.csv,77,18,59,0.23376623376623376,0,0,0,0.0,0.0,0.0
IND-JLMIV+R-2020,commons-lang-2.3.csv,77,16,61,0.2077922077922078,0,0,0,0.0,0.0,0.0
IND-JLMIV+R-2020,commons-lang-2.4.csv,80,17,63,0.2125,0,0,0,0.0,0.0,0.0
IND-JLMIV+R-2020,commons-lang-2.5.csv,85,10,75,0.11764705882352941,0,0,0,0.0,0.0,0.0
IND-JLMIV+R-2020,commons-lang-2.6.csv,86,8,78,0.09302325581395349,0,0,0,0.0,0.0,0.0
IND-JLMIV+R-2020,commons-lang-3.0.csv,99,16,83,0.16161616161616163,0,0,0,0.0,0.0,0.0
IND-JLMIV+R-2020,commons-lang-3.1.csv,99,20,79,0.20202020202020202,0,0,0,0.0,0.0,0.0
IND-JLMIV+R-2020,commons-lang-3.2.csv,112,21,91,0.1875,1,1,0,0.008928571428571428,0.047619047619047616,0.0
IND-JLMIV+R-2020,commons-lang-3.3.csv,120,17,103,0.14166666666666666,1,0,1,0.008333333333333333,0.0,0.009708737864077669
IND-JLMIV+R-2020,commons-lang-3.4.csv,121,14,107,0.11570247933884298,0,0,0,0.0,0.0,0.0
IND-JLMIV+R-2020,commons-lang-3.5.csv,131,9,122,0.06870229007633588,0,0,0,0.0,0.0,0.0
IND-JLMIV+R-2020,commons-lang-3.6.csv,135,6,129,0.044444444444444446,0,0,0,0.0,0.0,0.0
IND-JLMIV+R-2020,commons-lang-3.7.csv,138,4,134,0.028985507246376812,0,0,0,0.0,0.0,0.0
IND-JLMIV+R-2020,commons-math-1.0.csv,106,6,100,0.05660377358490566,0,0,0,0.0,0.0,0.0
IND-JLMIV+R-2020,commons-math-1.1.csv,120,7,113,0.058333333333333334,1,0,1,0.008333333333333333,0.0,0.008849557522123894
IND-JLMIV+R-2020,commons-math-1.2.csv,223,11,212,0.04932735426008968,1,1,0,0.004484304932735426,0.09090909090909091,0.0
IND-JLMIV+R-2020,commons-math-2.0.csv,388,28,360,0.07216494845360824,1,0,1,0.002577319587628866,0.0,0.002777777777777778
IND-JLMIV+R-2020,commons-math-2.1.csv,408,21,387,0.051470588235294115,1,1,0,0.0024509803921568627,0.047619047619047616,0.0
IND-JLMIV+R-2020,commons-math-2.2.csv,457,14,443,0.030634573304157548,0,0,0,0.0,0.0,0.0
IND-JLMIV+R-2020,commons-math-3.0.csv,568,29,539,0.051056338028169015,0,0,0,0.0,0.0,0.0
IND-JLMIV+R-2020,commons-math-3.1.csv,693,49,644,0.0707070707070707,3,2,1,0.004329004329004329,0.04081632653061224,0.0015527950310559005
IND-JLMIV+R-2020,commons-math-3.2.csv,725,33,692,0.04551724137931035,5,1,4,0.006896551724137931,0.030303030303030304,0.005780346820809248
IND-JLMIV+R-2020,commons-math-3.3.csv,825,20,805,0.024242424242424242,3,2,1,0.0036363636363636364,0.1,0.0012422360248447205
IND-JLMIV+R-2020,commons-math-3.4.csv,852,8,844,0.009389671361502348,0,0,0,0.0,0.0,0.0
IND-JLMIV+R-2020,commons-math-3.5.csv,852,6,846,0.007042253521126761,0,0,0,0.0,0.0,0.0
IND-JLMIV+R-2020,commons-math-3.6.csv,914,0,914,0.0,0,0,0,0.0,,0.0
IND-JLMIV+R-2020,commons-net-1.0.csv,92,7,85,0.07608695652173914,1,0,1,0.010869565217391304,0.0,0.011764705882352941
IND-JLMIV+R-2020,commons-net-1.1.csv,108,11,97,0.10185185185185185,1,1,0,0.009259259259259259,0.09090909090909091,0.0
IND-JLMIV+R-2020,commons-net-1.2.csv,117,14,103,0.11965811965811966,1,1,0,0.008547008547008548,0.07142857142857142,0.0
IND-JLMIV+R-2020,commons-net-1.3.csv,129,16,113,0.12403100775193798,1,1,0,0.007751937984496124,0.0625,0.0
IND-JLMIV+R-2020,commons-net-1.4.csv,270,17,253,0.06296296296296296,1,1,0,0.003703703703703704,0.058823529411764705,0.0
IND-JLMIV+R-2020,commons-net-2.0.csv,126,25,101,0.1984126984126984,1,1,0,0.007936507936507936,0.04,0.0
IND-JLMIV+R-2020,commons-net-2.1.csv,130,20,110,0.15384615384615385,0,0,0,0.0,0.0,0.0
IND-JLMIV+R-2020,commons-net-2.2.csv,132,18,114,0.13636363636363635,1,1,0,0.007575757575757576,0.05555555555555555,0.0
IND-JLMIV+R-2020,commons-net-3.0.csv,152,21,131,0.13815789473684212,0,0,0,0.0,0.0,0.0
IND-JLMIV+R-2020,commons-net-3.1.csv,153,20,133,0.13071895424836602,0,0,0,0.0,0.0,0.0
IND-JLMIV+R-2020,commons-net-3.2.csv,153,18,135,0.11764705882352941,0,0,0,0.0,0.0,0.0
IND-JLMIV+R-2020,commons-net-3.3.csv,155,18,137,0.11612903225806452,0,0,0,0.0,0.0,0.0
IND-JLMIV+R-2020,commons-net-3.4.csv,156,9,147,0.057692307692307696,0,0,0,0.0,0.0,0.0
IND-JLMIV+R-2020,commons-net-3.5.csv,156,9,147,0.057692307692307696,0,0,0,0.0,0.0,0.0
IND-JLMIV+R-2020,commons-net-3.6.csv,156,3,153,0.019230769230769232,0,0,0,0.0,0.0,0.0
IND-JLMIV+R-2020,commons-scxml-0.5.csv,72,10,62,0.1388888888888889,0,0,0,0.0,0.0,0.0
IND-JLMIV+R-2020,commons-scxml-0.6.csv,75,12,63,0.16,1,0,1,0.013333333333333334,0.0,0.015873015873015872
IND-JLMIV+R-2020,commons-scxml-0.7.csv,79,15,64,0.189873417721519,1,1,0,0.012658227848101266,0.06666666666666667,0.0
IND-JLMIV+R-2020,commons-scxml-0.8.csv,79,15,64,0.189873417721519,1,1,0,0.012658227848101266,0.06666666666666667,0.0
IND-JLMIV+R-2020,commons-scxml-0.9.csv,79,5,74,0.06329113924050633,0,0,0,0.0,0.0,0.0
IND-JLMIV+R-2020,commons-validator-1.0.csv,17,0,17,0.0,0,0,0,0.0,,0.0
IND-JLMIV+R-2020,commons-validator-1.1.0.csv,23,3,20,0.13043478260869565,0,0,0,0.0,0.0,0.0
IND-JLMIV+R-2020,commons-validator-1.2.0.csv,22,7,15,0.3181818181818182,0,0,0,0.0,0.0,0.0
IND-JLMIV+R-2020,commons-validator-1.3.0.csv,38,7,31,0.18421052631578946,0,0,0,0.0,0.0,0.0
IND-JLMIV+R-2020,commons-validator-1.4.0.csv,59,6,53,0.1016949152542373,0,0,0,0.0,0.0,0.0
IND-JLMIV+R-2020,commons-validator-1.5.0.csv,62,3,59,0.04838709677419355,0,0,0,0.0,0.0,0.0
IND-JLMIV+R-2020,commons-validator-1.6.0.csv,63,1,62,0.015873015873015872,0,0,0,0.0,0.0,0.0
IND-JLMIV+R-2020,commons-vfs-1.0.csv,236,26,210,0.11016949152542373,0,0,0,0.0,0.0,0.0
IND-JLMIV+R-2020,commons-vfs-2.0.csv,251,25,226,0.099601593625498,0,0,0,0.0,0.0,0.0
IND-JLMIV+R-2020,commons-vfs-2.1.csv,259,3,256,0.011583011583011582,2,1,1,0.007722007722007722,0.3333333333333333,0.00390625
IND-JLMIV+R-2020,commons-vfs-2.2.csv,262,2,260,0.007633587786259542,2,1,1,0.007633587786259542,0.5,0.0038461538461538464
IND-JLMIV+R-2020,deltaspike-0.1.csv,56,2,54,0.03571428571428571,0,0,0,0.0,0.0,0.0
IND-JLMIV+R-2020,deltaspike-0.2.csv,188,13,175,0.06914893617021277,1,0,1,0.005319148936170213,0.0,0.005714285714285714
IND-JLMIV+R-2020,deltaspike-0.3.csv,181,19,162,0.10497237569060773,3,1,2,0.016574585635359115,0.05263157894736842,0.012345679012345678
IND-JLMIV+R-2020,deltaspike-0.4.csv,314,25,289,0.07961783439490445,3,2,1,0.009554140127388535,0.08,0.0034602076124567475
IND-JLMIV+R-2020,deltaspike-0.5.csv,492,32,460,0.06504065040650407,2,1,1,0.0040650406504065045,0.03125,0.002173913043478261
IND-JLMIV+R-2020,deltaspike-0.6.csv,578,28,550,0.04844290657439446,4,1,3,0.006920415224913495,0.03571428571428571,0.005454545454545455
IND-JLMIV+R-2020,deltaspike-0.7.csv,589,29,560,0.04923599320882852,4,1,3,0.006791171477079796,0.034482758620689655,0.005357142857142857
IND-JLMIV+R-2020,deltaspike-1.0.0.csv,615,28,587,0.04552845528455285,4,1,3,0.0065040650406504065,0.03571428571428571,0.005110732538330494
IND-JLMIV+R-2020,deltaspike-1.1.0.csv,634,26,608,0.04100946372239748,4,1,3,0.006309148264984227,0.038461538461538464,0.004934210526315789
IND-JLMIV+R-2020,deltaspike-1.2.0.csv,636,24,612,0.03773584905660377,3,0,3,0.0047169811320754715,0.0,0.004901960784313725
IND-JLMIV+R-2020,deltaspike-1.3.0.csv,645,21,624,0.03255813953488372,3,0,3,0.004651162790697674,0.0,0.004807692307692308
IND-JLMIV+R-2020,deltaspike-1.4.0.csv,649,24,625,0.03697996918335902,4,1,3,0.0061633281972265025,0.041666666666666664,0.0048
IND-JLMIV+R-2020,deltaspike-1.5.0.csv,661,24,637,0.036308623298033284,4,2,2,0.006051437216338881,0.08333333333333333,0.0031397174254317113
IND-JLMIV+R-2020,deltaspike-1.6.0.csv,693,14,679,0.020202020202020204,4,0,4,0.005772005772005772,0.0,0.005891016200294551
IND-JLMIV+R-2020,deltaspike-1.7.0.csv,708,12,696,0.01694915254237288,4,0,4,0.005649717514124294,0.0,0.005747126436781609
IND-JLMIV+R-2020,deltaspike-1.8.0.csv,725,8,717,0.011034482758620689,4,2,2,0.005517241379310344,0.25,0.002789400278940028
IND-JLMIV+R-2020,eagle-0.3.0.csv,681,18,663,0.02643171806167401,0,0,0,0.0,0.0,0.0
IND-JLMIV+R-2020,eagle-0.4.0.csv,731,4,727,0.005471956224350205,0,0,0,0.0,0.0,0.0
IND-JLMIV+R-2020,eagle-0.5.0.csv,118,0,118,0.0,0,0,0,0.0,,0.0
IND-JLMIV+R-2020,giraph-0.1.0.csv,105,0,105,0.0,0,0,0,0.0,,0.0
IND-JLMIV+R-2020,giraph-1.0.0.csv,431,27,404,0.06264501160092807,0,0,0,0.0,0.0,0.0
IND-JLMIV+R-2020,giraph-1.1.0.csv,753,15,738,0.0199203187250996,0,0,0,0.0,0.0,0.0
IND-JLMIV+R-2020,gora-0.1.csv,97,11,86,0.1134020618556701,0,0,0,0.0,0.0,0.0
IND-JLMIV+R-2020,gora-0.2.csv,104,9,95,0.08653846153846154,0,0,0,0.0,0.0,0.0
IND-JLMIV+R-2020,gora-0.3.csv,132,5,127,0.03787878787878788,0,0,0,0.0,0.0,0.0
IND-JLMIV+R-2020,gora-0.4.csv,146,11,135,0.07534246575342465,0,0,0,0.0,0.0,0.0
IND-JLMIV+R-2020,gora-0.5.csv,169,13,156,0.07692307692307693,0,0,0,0.0,0.0,0.0
IND-JLMIV+R-2020,gora-0.6.csv,170,9,161,0.052941176470588235,0,0,0,0.0,0.0,0.0
IND-JLMIV+R-2020,gora-0.7.csv,201,0,201,0.0,0,0,0,0.0,,0.0
IND-JLMIV+R-2020,gora-0.8.csv,210,0,210,0.0,0,0,0,0.0,,0.0
IND-JLMIV+R-2020,jspwiki-1.4.0.csv,13,1,12,0.07692307692307693,0,0,0,0.0,0.0,0.0
IND-JLMIV+R-2020,jspwiki-1.5.0.csv,13,1,12,0.07692307692307693,0,0,0,0.0,0.0,0.0
IND-JLMIV+R-2020,jspwiki-1.6.0.csv,14,1,13,0.07142857142857142,0,0,0,0.0,0.0,0.0
IND-JLMIV+R-2020,jspwiki-1.7.0.csv,34,1,33,0.029411764705882353,0,0,0,0.0,0.0,0.0
IND-JLMIV+R-2020,jspwiki-1.8.0.csv,39,1,38,0.02564102564102564,0,0,0,0.0,0.0,0.0
IND-JLMIV+R-2020,jspwiki-2.0.36.csv,103,1,102,0.009708737864077669,0,0,0,0.0,0.0,0.0
IND-JLMIV+R-2020,jspwiki-2.10.0.csv,351,3,348,0.008547008547008548,0,0,0,0.0,0.0,0.0
IND-JLMIV+R-2020,jspwiki-2.2.19.csv,218,1,217,0.0045871559633027525,0,0,0,0.0,0.0,0.0
IND-JLMIV+R-2020,jspwiki-2.4.56.csv,307,9,298,0.029315960912052116,1,0,1,0.003257328990228013,0.0,0.003355704697986577
IND-JLMIV+R-2020,jspwiki-2.6.0.csv,364,17,347,0.046703296703296704,1,1,0,0.0027472527472527475,0.058823529411764705,0.0
IND-JLMIV+R-2020,jspwiki-2.8.0.csv,730,4,726,0.005479452054794521,0,0,0,0.0,0.0,0.0
IND-JLMIV+R-2020,jspwiki-2.9.0.csv,372,4,368,0.010752688172043012,0,0,0,0.0,0.0,0.0
IND-JLMIV+R-2020,knox-0.10.0.csv,621,27,594,0.043478260869565216,5,4,1,0.008051529790660225,0.14814814814814814,0.0016835016835016834
IND-JLMIV+R-2020,knox-0.11.0.csv,648,26,622,0.040123456790123455,2,2,0,0.0030864197530864196,0.07692307692307693,0.0
IND-JLMIV+R-2020,knox-0.12.0.csv,670,22,648,0.03283582089552239,1,1,0,0.0014925373134328358,0.045454545454545456,0.0
IND-JLMIV+R-2020,knox-0.13.0.csv,683,12,671,0.017569546120058566,1,0,1,0.0014641288433382138,0.0,0.0014903129657228018
IND-JLMIV+R-2020,knox-0.14.0.csv,738,8,730,0.01084010840108401,0,0,0,0.0,0.0,0.0
IND-JLMIV+R-2020,knox-0.3.0.csv,388,41,347,0.1056701030927835,20,0,20,0.05154639175257732,0.0,0.05763688760806916
IND-JLMIV+R-2020,knox-0.4.0.csv,444,36,408,0.08108108108108109,29,0,29,0.06531531531531531,0.0,0.07107843137254902
IND-JLMIV+R-2020,knox-0.5.0.csv,496,49,447,0.09879032258064516,35,14,21,0.07056451612903226,0.2857142857142857,0.04697986577181208
IND-JLMIV+R-2020,knox-0.6.0.csv,542,69,473,0.12730627306273062,35,26,9,0.06457564575645756,0.37681159420289856,0.019027484143763214
IND-JLMIV+R-2020,knox-0.7.0.csv,590,32,558,0.05423728813559322,10,10,0,0.01694915254237288,0.3125,0.0
IND-JLMIV+R-2020,knox-0.8.0.csv,594,33,561,0.05555555555555555,10,10,0,0.016835016835016835,0.30303030303030304,0.0
IND-JLMIV+R-2020,knox-0.9.0.csv,609,25,584,0.041050903119868636,5,3,2,0.008210180623973728,0.12,0.003424657534246575
IND-JLMIV+R-2020,knox-1.0.0.csv,762,24,738,0.031496062992125984,0,0,0,0.0,0.0,0.0
IND-JLMIV+R-2020,kylin-0.6.1.csv,376,11,365,0.02925531914893617,0,0,0,0.0,0.0,0.0
IND-JLMIV+R-2020,kylin-0.7.1.csv,489,28,461,0.05725971370143149,2,0,2,0.00408997955010225,0.0,0.004338394793926247
IND-JLMIV+R-2020,kylin-1.0.0.csv,505,23,482,0.04554455445544554,9,1,8,0.01782178217821782,0.043478260869565216,0.016597510373443983
IND-JLMIV+R-2020,kylin-1.1.0.csv,504,17,487,0.03373015873015873,9,1,8,0.017857142857142856,0.058823529411764705,0.01642710472279261
IND-JLMIV+R-2020,kylin-1.2.0.csv,514,17,497,0.033073929961089495,7,1,6,0.013618677042801557,0.058823529411764705,0.012072434607645875
IND-JLMIV+R-2020,kylin-1.3.0.csv,530,11,519,0.020754716981132074,9,0,9,0.016981132075471698,0.0,0.017341040462427744
IND-JLMIV+R-2020,kylin-1.5.0.csv,739,60,679,0.08119079837618404,10,7,3,0.013531799729364006,0.11666666666666667,0.004418262150220913
IND-JLMIV+R-2020,kylin-1.6.0.csv,790,39,751,0.049367088607594936,8,2,6,0.010126582278481013,0.05128205128205128,0.007989347536617843
IND-JLMIV+R-2020,kylin-2.0.0.csv,856,38,818,0.04439252336448598,17,0,17,0.01985981308411215,0.0,0.02078239608801956
IND-JLMIV+R-2020,kylin-2.1.0.csv,936,55,881,0.05876068376068376,18,15,3,0.019230769230769232,0.2727272727272727,0.00340522133938706
IND-JLMIV+R-2020,kylin-2.2.0.csv,1003,47,956,0.04685942173479561,14,12,2,0.013958125623130608,0.2553191489361702,0.0020920502092050207
IND-JLMIV+R-2020,lens-2.6.0.csv,584,12,572,0.02054794520547945,0,0,0,0.0,0.0,0.0
IND-JLMIV+R-2020,lens-2.7.0.csv,201,0,201,0.0,0,0,0,0.0,,0.0
IND-JLMIV+R-2020,mahout-0.1.csv,264,28,236,0.10606060606060606,1,0,1,0.003787878787878788,0.0,0.00423728813559322
IND-JLMIV+R-2020,mahout-0.10.0.csv,823,9,814,0.010935601458080195,1,1,0,0.001215066828675577,0.1111111111111111,0.0
IND-JLMIV+R-2020,mahout-0.11.0.csv,829,4,825,0.0048250904704463205,0,0,0,0.0,0.0,0.0
IND-JLMIV+R-2020,mahout-0.12.0.csv,810,1,809,0.0012345679012345679,0,0,0,0.0,0.0,0.0
IND-JLMIV+R-2020,mahout-0.13.0.csv,814,0,814,0.0,0,0,0,0.0,,0.0
IND-JLMIV+R-2020,mahout-0.2.csv,425,25,400,0.058823529411764705,3,0,3,0.007058823529411765,0.0,0.0075
IND-JLMIV+R-2020,mahout-0.3.csv,699,29,670,0.04148783977110158,6,1,5,0.008583690987124463,0.034482758620689655,0.007462686567164179
IND-JLMIV+R-2020,mahout-0.4.csv,763,73,690,0.09567496723460026,16,5,11,0.020969855832241154,0.0684931506849315,0.015942028985507246
IND-JLMIV+R-2020,mahout-0.5.csv,777,53,724,0.0682110682110682,11,11,0,0.014157014157014158,0.20754716981132076,0.0
IND-JLMIV+R-2020,mahout-0.6.csv,893,52,841,0.05823068309070549,0,0,0,0.0,0.0,0.0
IND-JLMIV+R-2020,mahout-0.7.csv,834,38,796,0.045563549160671464,0,0,0,0.0,0.0,0.0
IND-JLMIV+R-2020,mahout-0.8.csv,906,33,873,0.03642384105960265,1,0,1,0.0011037527593818985,0.0,0.001145475372279496
IND-JLMIV+R-2020,mahout-0.9.csv,836,17,819,0.02033492822966507,1,1,0,0.0011961722488038277,0.058823529411764705,0.0
IND-JLMIV+R-2020,manifoldcf-0.1.csv,430,28,402,0.06511627906976744,9,6,3,0.020930232558139535,0.21428571428571427,0.007462686567164179
IND-JLMIV+R-2020,manifoldcf-0.2.csv,433,25,408,0.057736720554272515,9,4,5,0.020785219399538105,0.16,0.012254901960784314
IND-JLMIV+R-2020,manifoldcf-0.3.csv,492,28,464,0.056910569105691054,5,3,2,0.01016260162601626,0.10714285714285714,0.004310344827586207
IND-JLMIV+R-2020,manifoldcf-0.4.csv,513,32,481,0.06237816764132553,7,3,4,0.01364522417153996,0.09375,0.008316008316008316
IND-JLMIV+R-2020,manifoldcf-0.5.csv,546,34,512,0.06227106227106227,7,3,4,0.01282051282051282,0.08823529411764706,0.0078125
IND-JLMIV+R-2020,manifoldcf-0.6.csv,632,65,567,0.10284810126582279,7,6,1,0.011075949367088608,0.09230769230769231,0.001763668430335097
IND-JLMIV+R-2020,manifoldcf-1.0.csv,640,56,584,0.0875,4,3,1,0.00625,0.05357142857142857,0.0017123287671232876
IND-JLMIV+R-2020,manifoldcf-1.1.csv,647,55,592,0.08500772797527048,5,3,2,0.0077279752704791345,0.05454545454545454,0.0033783783783783786
IND-JLMIV+R-2020,manifoldcf-1.10.csv,999,19,980,0.01901901901901902,8,1,7,0.008008008008008008,0.05263157894736842,0.007142857142857143
IND-JLMIV+R-2020,manifoldcf-1.2.csv,688,57,631,0.08284883720930232,5,5,0,0.007267441860465116,0.08771929824561403,0.0
IND-JLMIV+R-2020,manifoldcf-1.3.csv,771,58,713,0.07522697795071336,9,4,5,0.011673151750972763,0.06896551724137931,0.0070126227208976155
IND-JLMIV+R-2020,manifoldcf-1.4.csv,780,43,737,0.05512820512820513,8,8,0,0.010256410256410256,0.18604651162790697,0.0
IND-JLMIV+R-2020,manifoldcf-1.5.csv,862,31,831,0.03596287703016241,2,1,1,0.002320185614849188,0.03225806451612903,0.0012033694344163659
IND-JLMIV+R-2020,manifoldcf-1.6.csv,863,32,831,0.03707995365005794,2,2,0,0.002317497103128621,0.0625,0.0
IND-JLMIV+R-2020,manifoldcf-1.7.csv,928,38,890,0.040948275862068964,1,1,0,0.0010775862068965517,0.02631578947368421,0.0
IND-JLMIV+R-2020,manifoldcf-1.8.csv,942,26,916,0.027600849256900213,5,1,4,0.005307855626326964,0.038461538461538464,0.004366812227074236
IND-JLMIV+R-2020,manifoldcf-1.9.csv,978,22,956,0.022494887525562373,6,1,5,0.006134969325153374,0.045454545454545456,0.005230125523012552
IND-JLMIV+R-2020,manifoldcf-2.0.csv,933,35,898,0.03751339764201501,5,4,1,0.0053590568060021436,0.11428571428571428,0.0011135857461024498
IND-JLMIV+R-2020,manifoldcf-2.1.csv,969,34,935,0.03508771929824561,7,6,1,0.007223942208462332,0.17647058823529413,0.0010695187165775401
IND-JLMIV+R-2020,manifoldcf-2.10.csv,1058,11,1047,0.010396975425330813,0,0,0,0.0,0.0,0.0
IND-JLMIV+R-2020,manifoldcf-2.2.csv,995,32,963,0.032160804020100506,9,6,3,0.009045226130653266,0.1875,0.003115264797507788
IND-JLMIV+R-2020,manifoldcf-2.3.csv,1017,37,980,0.03638151425762045,9,5,4,0.008849557522123894,0.13513513513513514,0.004081632653061225
IND-JLMIV+R-2020,manifoldcf-2.4.csv,1020,32,988,0.03137254901960784,10,4,6,0.00980392156862745,0.125,0.006072874493927126
IND-JLMIV+R-2020,manifoldcf-2.5.csv,1021,28,993,0.02742409402546523,10,2,8,0.009794319294809012,0.07142857142857142,0.008056394763343404
IND-JLMIV+R-2020,manifoldcf-2.6.csv,1026,26,1000,0.025341130604288498,10,2,8,0.009746588693957114,0.07692307692307693,0.008
IND-JLMIV+R-2020,manifoldcf-2.7.csv,1026,15,1011,0.014619883040935672,11,1,10,0.010721247563352826,0.06666666666666667,0.009891196834817012
IND-JLMIV+R-2020,manifoldcf-2.8.csv,1041,24,1017,0.023054755043227664,11,11,0,0.010566762728146013,0.4583333333333333,0.0
IND-JLMIV+R-2020,manifoldcf-2.9.csv,1047,13,1034,0.012416427889207259,0,0,0,0.0,0.0,0.0
IND-JLMIV+R-2020,nutch-0.7.csv,327,14,313,0.04281345565749235,1,0,1,0.0030581039755351682,0.0,0.003194888178913738
IND-JLMIV+R-2020,nutch-0.8.csv,319,28,291,0.0877742946708464,2,1,1,0.006269592476489028,0.03571428571428571,0.003436426116838488
IND-JLMIV+R-2020,nutch-0.9.csv,332,26,306,0.0783132530120482,3,1,2,0.009036144578313253,0.038461538461538464,0.006535947712418301
IND-JLMIV+R-2020,nutch-1.0.csv,358,36,322,0.1005586592178771,3,0,3,0.008379888268156424,0.0,0.009316770186335404
IND-JLMIV+R-2020,nutch-1.1.csv,364,31,333,0.08516483516483517,5,0,5,0.013736263736263736,0.0,0.015015015015015015
IND-JLMIV+R-2020,nutch-1.10.csv,284,14,270,0.04929577464788732,12,3,9,0.04225352112676056,0.21428571428571427,0.03333333333333333
IND-JLMIV+R-2020,nutch-1.11.csv,382,13,369,0.034031413612565446,9,2,7,0.02356020942408377,0.15384615384615385,0.018970189701897018
IND-JLMIV+R-2020,nutch-1.12.csv,397,27,370,0.06801007556675064,9,7,2,0.022670025188916875,0.25925925925925924,0.005405405405405406
IND-JLMIV+R-2020,nutch-1.13.csv,404,25,379,0.06188118811881188,3,2,1,0.007425742574257425,0.08,0.002638522427440633
IND-JLMIV+R-2020,nutch-1.14.csv,413,7,406,0.01694915254237288,1,1,0,0.002421307506053269,0.14285714285714285,0.0
IND-JLMIV+R-2020,nutch-1.2.csv,371,24,347,0.0646900269541779,7,0,7,0.018867924528301886,0.0,0.020172910662824207
IND-JLMIV+R-2020,nutch-1.3.csv,245,25,220,0.10204081632653061,7,1,6,0.02857142857142857,0.04,0.02727272727272727
IND-JLMIV+R-2020,nutch-1.4.csv,246,26,220,0.10569105691056911,8,1,7,0.032520325203252036,0.038461538461538464,0.031818181818181815
IND-JLMIV+R-2020,nutch-1.5.csv,249,31,218,0.12449799196787148,8,4,4,0.0321285140562249,0.12903225806451613,0.01834862385321101
IND-JLMIV+R-2020,nutch-1.6.csv,250,28,222,0.112,9,4,5,0.036,0.14285714285714285,0.02252252252252252
IND-JLMIV+R-2020,nutch-1.7.csv,254,20,234,0.07874015748031496,9,3,6,0.03543307086614173,0.15,0.02564102564102564
IND-JLMIV+R-2020,nutch-1.8.csv,256,11,245,0.04296875,9,0,9,0.03515625,0.0,0.036734693877551024
IND-JLMIV+R-2020,nutch-1.9.csv,246,9,237,0.036585365853658534,11,0,11,0.044715447154471545,0.0,0.046413502109704644
IND-JLMIV+R-2020,nutch-2.0.csv,500,23,477,0.046,10,1,9,0.02,0.043478260869565216,0.018867924528301886
IND-JLMIV+R-2020,nutch-2.1.csv,252,19,233,0.07539682539682539,12,0,12,0.047619047619047616,0.0,0.05150214592274678
IND-JLMIV+R-2020,nutch-2.2.csv,255,32,223,0.12549019607843137,11,10,1,0.043137254901960784,0.3125,0.004484304932735426
IND-JLMIV+R-2020,nutch-2.3.csv,323,9,314,0.02786377708978328,0,0,0,0.0,0.0,0.0
IND-JLMIV+R-2020,opennlp-1.7.0.csv,632,11,621,0.01740506329113924,0,0,0,0.0,0.0,0.0
IND-JLMIV+R-2020,opennlp-1.8.0.csv,626,5,621,0.007987220447284345,0,0,0,0.0,0.0,0.0
IND-JLMIV+R-2020,parquet-mr-1.0.0.csv,221,5,216,0.02262443438914027,0,0,0,0.0,0.0,0.0
IND-JLMIV+R-2020,parquet-mr-1.1.0.csv,224,5,219,0.022321428571428572,0,0,0,0.0,0.0,0.0
IND-JLMIV+R-2020,parquet-mr-1.2.0.csv,236,5,231,0.0211864406779661,0,0,0,0.0,0.0,0.0
IND-JLMIV+R-2020,parquet-mr-1.3.0.csv,274,7,267,0.025547445255474453,1,0,1,0.0036496350364963502,0.0,0.003745318352059925
IND-JLMIV+R-2020,parquet-mr-1.4.0.csv,309,16,293,0.05177993527508091,1,0,1,0.003236245954692557,0.0,0.0034129692832764505
IND-JLMIV+R-2020,parquet-mr-1.5.0.csv,323,19,304,0.058823529411764705,1,1,0,0.0030959752321981426,0.05263157894736842,0.0
IND-JLMIV+R-2020,parquet-mr-1.6.0.csv,377,13,364,0.034482758620689655,1,1,0,0.002652519893899204,0.07692307692307693,0.0
IND-JLMIV+R-2020,parquet-mr-1.7.0.csv,377,30,347,0.07957559681697612,0,0,0,0.0,0.0,0.0
IND-JLMIV+R-2020,santuario-java-1.0.0.csv,165,0,165,0.0,0,0,0,0.0,,0.0
IND-JLMIV+R-2020,santuario-java-1.2.0.csv,121,0,121,0.0,0,0,0,0.0,,0.0
IND-JLMIV+R-2020,santuario-java-1.4.5.csv,257,2,255,0.007782101167315175,0,0,0,0.0,0.0,0.0
IND-JLMIV+R-2020,santuario-java-2.0.0.csv,389,21,368,0.05398457583547558,0,0,0,0.0,0.0,0.0
IND-JLMIV+R-2020,santuario-java-2.1.0.csv,463,1,462,0.0021598272138228943,0,0,0,0.0,0.0,0.0
IND-JLMIV+R-2020,systemml-0.10.csv,884,70,814,0.07918552036199095,6,1,5,0.006787330316742082,0.014285714285714285,0.006142506142506142
IND-JLMIV+R-2020,systemml-0.11.csv,973,90,883,0.09249743062692703,6,4,2,0.006166495375128468,0.044444444444444446,0.0022650056625141564
IND-JLMIV+R-2020,systemml-0.12.csv,964,87,877,0.09024896265560166,5,4,1,0.005186721991701245,0.04597701149425287,0.0011402508551881414
IND-JLMIV+R-2020,systemml-0.13.csv,971,79,892,0.08135942327497425,4,3,1,0.004119464469618949,0.0379746835443038,0.0011210762331838565
IND-JLMIV+R-2020,systemml-0.14.csv,1008,74,934,0.07341269841269842,2,1,1,0.001984126984126984,0.013513513513513514,0.0010706638115631692
IND-JLMIV+R-2020,systemml-0.15.csv,1029,57,972,0.05539358600583091,1,1,0,0.0009718172983479105,0.017543859649122806,0.0
IND-JLMIV+R-2020,systemml-0.9.csv,851,70,781,0.08225616921269095,2,0,2,0.0023501762632197414,0.0,0.002560819462227913
IND-JLMIV+R-2020,systemml-1.0.0.csv,1042,45,997,0.04318618042226487,1,0,1,0.0009596928982725527,0.0,0.0010030090270812437
IND-JLMIV+R-2020,systemml-1.1.0.csv,1035,43,992,0.04154589371980676,1,1,0,0.000966183574879227,0.023255813953488372,0.0
IND-JLMIV+R-2020,systemml-1.2.0.csv,1073,0,1073,0.0,0,0,0,0.0,,0.0
IND-JLMIV+R-2020,tika-0.1.csv,61,5,56,0.08196721311475409,0,0,0,0.0,0.0,0.0
IND-JLMIV+R-2020,tika-0.10.csv,269,41,228,0.1524163568773234,8,6,2,0.02973977695167286,0.14634146341463414,0.008771929824561403
IND-JLMIV+R-2020,tika-0.2.csv,101,15,86,0.1485148514851485,1,0,1,0.009900990099009901,0.0,0.011627906976744186
IND-JLMIV+R-2020,tika-0.3.csv,119,16,103,0.13445378151260504,2,0,2,0.01680672268907563,0.0,0.019417475728155338
IND-JLMIV+R-2020,tika-0.4.csv,135,13,122,0.0962962962962963,2,0,2,0.014814814814814815,0.0,0.01639344262295082
IND-JLMIV+R-2020,tika-0.5.csv,146,11,135,0.07534246575342465,2,0,2,0.0136986301369863,0.0,0.014814814814814815
IND-JLMIV+R-2020,tika-0.6.csv,149,17,132,0.11409395973154363,2,0,2,0.013422818791946308,0.0,0.015151515151515152
IND-JLMIV+R-2020,tika-0.7.csv,159,20,139,0.12578616352201258,4,0,4,0.025157232704402517,0.0,0.02877697841726619
IND-JLMIV+R-2020,tika-0.8.csv,200,31,169,0.155,9,3,6,0.045,0.0967741935483871,0.03550295857988166
IND-JLMIV+R-2020,tika-0.9.csv,222,44,178,0.1981981981981982,9,8,1,0.04054054054054054,0.18181818181818182,0.0056179775280898875
IND-JLMIV+R-2020,tika-1.0.csv,269,40,229,0.14869888475836432,10,8,2,0.03717472118959108,0.2,0.008733624454148471
IND-JLMIV+R-2020,tika-1.1.csv,275,33,242,0.12,7,6,1,0.025454545454545455,0.18181818181818182,0.004132231404958678
IND-JLMIV+R-2020,tika-1.10.csv,473,22,451,0.046511627906976744,7,0,7,0.014799154334038054,0.0,0.015521064301552107
IND-JLMIV+R-2020,tika-1.11.csv,479,27,452,0.05636743215031315,6,3,3,0.012526096033402923,0.1111111111111111,0.00663716814159292
IND-JLMIV+R-2020,tika-1.12.csv,488,26,462,0.05327868852459016,4,2,2,0.00819672131147541,0.07692307692307693,0.004329004329004329
IND-JLMIV+R-2020,tika-1.13.csv,506,22,484,0.043478260869565216,2,0,2,0.003952569169960474,0.0,0.004132231404958678
IND-JLMIV+R-2020,tika-1.14.csv,538,25,513,0.046468401486988845,2,0,2,0.0037174721189591076,0.0,0.003898635477582846
IND-JLMIV+R-2020,tika-1.15.csv,636,25,611,0.03930817610062893,2,0,2,0.0031446540880503146,0.0,0.0032733224222585926
IND-JLMIV+R-2020,tika-1.16.csv,642,24,618,0.037383177570093455,2,0,2,0.003115264797507788,0.0,0.003236245954692557
IND-JLMIV+R-2020,tika-1.17.csv,651,16,635,0.02457757296466974,2,0,2,0.0030721966205837174,0.0,0.0031496062992125984
IND-JLMIV+R-2020,tika-1.2.csv,307,38,269,0.1237785016286645,8,8,0,0.026058631921824105,0.21052631578947367,0.0
IND-JLMIV+R-2020,tika-1.3.csv,311,30,281,0.09646302250803858,9,6,3,0.028938906752411574,0.2,0.010676156583629894
IND-JLMIV+R-2020,tika-1.4.csv,318,33,285,0.10377358490566038,8,7,1,0.025157232704402517,0.21212121212121213,0.0035087719298245615
IND-JLMIV+R-2020,tika-1.5.csv,321,20,301,0.06230529595015576,6,3,3,0.018691588785046728,0.15,0.009966777408637873
IND-JLMIV+R-2020,tika-1.6.csv,344,23,321,0.06686046511627906,4,3,1,0.011627906976744186,0.13043478260869565,0.003115264797507788
IND-JLMIV+R-2020,tika-1.7.csv,363,21,342,0.05785123966942149,4,3,1,0.011019283746556474,0.14285714285714285,0.0029239766081871343
IND-JLMIV+R-2020,tika-1.8.csv,436,19,417,0.04357798165137615,5,2,3,0.011467889908256881,0.10526315789473684,0.007194244604316547
IND-JLMIV+R-2020,tika-1.9.csv,464,28,436,0.0603448275862069,8,4,4,0.017241379310344827,0.14285714285714285,0.009174311926605505
IND-JLMIV+R-2020,wss4j-1.5.0.csv,278,12,266,0.04316546762589928,0,0,0,0.0,0.0,0.0
IND-JLMIV+R-2020,wss4j-1.6.0.csv,135,13,122,0.0962962962962963,0,0,0,0.0,0.0,0.0
IND-JLMIV+R-2020,wss4j-2.0.0.csv,482,11,471,0.022821576763485476,0,0,0,0.0,0.0,0.0
IND-JLMIV+R-2020,wss4j-2.1.0.csv,493,10,483,0.02028397565922921,0,0,0,0.0,0.0,0.0
IND-JLMIV+R-2020,wss4j-2.2.0.csv,500,0,500,0.0,0,0,0,0.0,,0.0
